111111111111
122221100001
100001100001
100001100001
100000000001
100100001001
100100301001
100111111001
100100001001
100001100001
111111111111